tileset
﻿64, 64
10, 10
3, 3, 3, 3, 3, 3, 3, 3, 3, 3
4, 4, 4, 2, 2, 2, 2, 2, 2, 3
3, 2, 4, 4, 1, 4, 2, 2, 2, 3
3, 2, 2, 2, 2, 4, 4, 4, 2, 3
3, 2, 2, 2, 2, 2, 2, 1, 2, 3
3, 3, 1, 3, 2, 2, 2, 4, 4, 3
3, 2, 2, 3, 2, 3, 2, 2, 4, 4
3, 2, 2, 3, 2, 3, 2, 2, 2, 3
3, 3, 3, 3, 3, 3, 2, 2, 2, 3
3, 3, 3, 3, 3, 3, 3, 3, 3, 3